Commands
ls - Displays information about files in the current directory.
  ls -a ; Displays all files, including hidden files
  ls -F ; Adds a forward slash to directories
  ls -i ; Displays inode number of files and directories 
  ls -g ; Displays file size in a human-readable format
  ls -l ; Prints detailed information about the directory contents in a columnar format
  ls -X ; Sorts files alphabetically by file extension
pwd - Displays the present current working directory.
mkdir - Creates a directory.
cd - To navigate between different folders.
rmdir - Removes empty directories from the directory lists.
cp - Copy files from one directory to another.
mv - Rename and Replace the files
rm - Delete files
uname - Command to get basic information about the OS
locate - Find a file in the database.
touch - Create empty files
cat - Display file contents on terminal
clear - clear terminal
ps - Display the processes in terminal
man - Access manual for all Linux commands
grep - Search for a specific string in an output
echo - Print string or text to the terminal
wget - download files from the internet.
whoami - Displays the current users name
sort - sort the file content
cal - view calendar in terminal
whereis - View the exact location of any command typed after this command
df - Check the details of the file system
wc - Check the lines, word count, and characters in a file using different options
